



     NO ./textures/wall1.png
SO ./textures/wall2.png
       WE ./textures/wall3.png
EA        ./textures/wall4.png

F                                  133,118,100


C 50,50,50

111111111111111111111111111111111111111111111111111111111111111111
1001000000Q00000000100000000000000010000000000010000000000000011Q1
10010001111111110001000111110001111111110001111100011111111000O001
10000000000000010000000100010000000000C000000000001001000000010001
111111110001000111111111000111100011111000100100001000111111111001
10000001000O000000000000000O00000010001000100010001000000000001001
10010001111C111111110001000100011110001111100010001111111110001001
100100000000001000100010000000100000000000100000000000100000001111
100111111111111100000011111000100011111000111111111000100011111001
100000000001000000010001001000O0000000100000000000C000100000000001
100111110001111100010001111100010001111111110001000100010001111111
100000010000000100010001000000010000000100000001000100010000000101
1O1111111111000100010001000111111111000100011111000100011111000111
100000000001000100000000000100000001000100000001000100000001000001
100111110001000111111111000111110001000111110001111100011111111111
100100000001000000000001000000000001000000010001000100000000000001
11110001111111110001000111110001111111110001000100011111C111111101
100100000000000100010001000100010000000000010000000000000001000101
100CC0111111100100010001000111110001111111110001111111110001000111
100100000O00110100010000000000010000000000010001000000010000000001
100100100011111000111110001111111110001111100010001111111110001001
1N0100000000000000100000000000100000000000000010000000000000001001
111111111111111111111111111111111111111111111111111111111111111111